13133313111113113111111111133333111111111111111111
11133311111111113111111111313311111111111111111131
11111111111111113311111111112111311111131111111333
11331122222211111222222211222000212200000222111131
11112220000211111220000020220000020000000000211111
11110000000021111200000000000000000000000000211311
11112000000002122200000000000000000000000000211111
11122000000000000000000000000000000000000000211111
11120000000000000000000000000000000000000000011133
11111220000000000000000000000000000000000000111131
11111112000000000000000000000000000000000000011111
11111120000000000000000000000000000000000002211311
11111120000000000000000000000000000000000021131311
11112220000000000000000000000000000000000021111131
11112000000000000000000000000000000000000002113133
11112000000000000000000000000000000000000002111111
11110000000000000000000000000000000000000002211133
11110000000000000000000000000000000000000002111113
13110000000000000000000000000000000000000002211113
33111200000000000000000000000000000000000002131313
11111112000000000000000000000000000000000000011333
11111112000000000000000000000000000000000000111311
11111112000000000000000000000000000000000000011133
11111200000000000000000000000000000000000002211133
11120000000000000000000000000000000000000000021113
11120000000000000000000000000000000000000000001333
11112200000000000000000000000000000000000000023333
33112000000000000000000000000000000000000000221333
11112000000000000000000000000000000000000002213333
33112000000000000000000000000000000000000000211333
31112000000000000000000000000000000000000002111133
11112000000000000000000000000000000000000002211133
13110000000000000000000000000000000000000002211113
33112000000000000000000000000000000000000002131313
11120000000000000000000000000000000000000000011333
11111220000000000000000000000000000000000021111311
11111112000000000000000000000000000000000002111133
11111112000000000000000000000000000000002211111133
11111120000000000000000000000000000000022111131113
11111220000000000000000000000000000000021111111333
11112000000000000000000000000000000000000211113333
33112000000000000000000000000000000000000002111333
11112000000000000000000000000000000000000002213333
33112000000000000000000000000000000000000000211333
13112200000000002222200000000000000000000000211133
11112220000000222111100000000000000000000000011113
11311122222211111331120000000000000002222222111111
13333111111111113333311111112222111111111113111313
11333331111133333333311111131111111111111331111311
11133311111111113111111111131111111111111111111111